BBBBBBBBBB
BOT(8,6)##GPPPB
B####PPPPB
BPFFF####B
BPF#PT(8,1)FFPB
BPP#FPPFFB
BPPPPPPFFB
BBBBBBBBBB
