BBBBBBBBBBBBBBBBBBBB
BGPPPPPPPPPPPPPPFFFB
BFFFF##P#######PPFFB
B###F#FFF#PPPP#PP##B
BFFFF#FFF#PPPP#PPPPB
BF########PPPP####PB
BFFFFFFFFF#PPPP#PPPB
B#####FFF##PPP#PP##B
BPPPPFFFFF#PPP#PPPPB
B#P#####P####P###PPB
BPPPPPPPF#FFFPPPFFFB
BP######FPPPPPPPPFFB
BP#PPPP#F#FFFFFFPFFB
BPPPPPP#P#FFFFFFPFFB
BP#PPPPPP#FFFFFFPPFB
B####P###########PPB
BPPPPPPPPPPPPPPPPPPB
BOPPPPPPP#PPPPPPPPPB
BBBBBBBBBBBBBBBBBBBB