BBBBBBBBBBBB
BGPPFFFFFFFB
B#FPPPPFFFFB
BF###PPPPPFB
BFFF#FFFFPFB
BFPO#FFFFPFB
BFPFFFFFFPFB
BPPFFFFFPPFB
BPPFFFPPPFFB
BFPPPPPFFFFB
BBBBBBBBBBBB